Field,Laureate name,Prize year,Title,Pub year,lag
Physics,"thouless, dj",2016,ordering metastability and phase transitions in two dimensional systems,1973,43
Physics,"kosterlitz, jm",2016,ordering metastability and phase transitions in two dimensional systems,1973,43
Physics,"haldane, fdm",2016,nonlinear field theory of large spin heisenberg antiferromagnets semiclassically quantized solitons of the one dimensional easy axis neel state,1983,33
Physics,"kajita, t",2015,evidence for oscillation of atmospheric neutrinos,1998,17
Physics,"mcdonald, ab",2015,direct evidence for neutrino flavor transformation from neutral current interactions in the sudbury neutrino observatory,2002,13
Physics,"mcdonald, ab",2015,measurement of the rate of ve d p p e interactions produced by 8b solar neutrinos at the sudbury neutrino observatory,2001,14
Physics,"akasaki, isamu",2014,p type conduction in mg doped gan treated with low energy electron beam irradiation leebi,1989,25
Physics,"amano, hiroshi",2014,p type conduction in mg doped gan treated with low energy electron beam irradiation leebi,1989,25
Physics,"nakamura, shuji",2014,candela class high brightness ingan algan double heterostructure blue light emitting diodes,1994,20
Physics,"englert, f",2013,broken symmetry and the mass of gauge vector mesons,1964,49
Physics,"higgs, pw",2013,broken symmetries and the masses of gauge bosons,1964,49
Physics,"higgs, pw",2013,broken symmetries massless particles and gauge fields,1964,49
Physics,"haroche, serge",2012,quantum rabi oscillation a direct test of field quantization in a cavity,1996,16
Physics,"haroche, serge",2012,observing the progressive decoherence of the meter in a quantum measurement,1996,16
Physics,"wineland, david",2012,demonstration of a fundamental quantum logic gate,1995,17
Physics,"wineland, david",2012,generation of nonclassical motional states of a trapped atom,1996,16
Physics,"wineland, david",2012,a schrodinger cat superposition state of an atom,1996,16
Physics,"perlmutter, s",2011,discovery of a supernova explosion at half the age of the universe,1998,13
Physics,"schmidt, bp",2011,observational evidence from supernovae for an accelerating universe and a cosmological constant,1998,13
Physics,"riess, adam g.",2011,observational evidence from supernovae for an accelerating universe and a cosmological constant,1998,13
Physics,"novoselov, kostya s.",2010,electric field effect in atomically thin carbon films,2004,6
Physics,"geim, andre k.",2010,electric field effect in atomically thin carbon films,2004,6
Physics,"kao, kc",2009,dielectric fibre surface waveguides for optical frequencies,1966,43
Physics,"boyle, ws",2009,charge coupled semiconductor devices,1970,39
Physics,"smith, ge",2009,charge coupled semiconductor devices,1970,39
Physics,"nambu, yoichiro",2008,quasi particles and gauge invariance in the theory of superconductivity,1960,48
Physics,"nambu, yoichiro",2008,dynamical model of elementary particles based on an analogy with superconductivity ii,1961,47
Physics,"nambu, yoichiro",2008,axial vector current conservation in weak interactions,1960,48
Physics,"kobayash, m",2008,cp violation in the renormalizable theory of weak interaction,1973,35
Physics,"maskawa, t",2008,cp violation in the renormalizable theory of weak interaction,1973,35
Physics,"fert, a",2007,giant magnetoresistance of 001 fe 001 cr magnetic superlattices,1988,19
Physics,"grunberg, p",2007,layered magnetic structures evidence for antiferromagnetic coupling of fe layers across cr interlayers,1986,21
Physics,"mather, jc",2006,a preliminary measurement of the cosmic microwave background spectrum by the cosmic background explorer cobe satellite,1990,16
Physics,"smoot, gf",2006,cobe differential microwave radiometers preliminary systematic error analysis,1992,14
Physics,"glauber, rj",2005,coherent and incoherent states of the radiation field,1963,42
Physics,"glauber, rj",2005,the quantum theory of optical coherence,1963,42
Physics,"hall, jl",2005,direct link between microwave and optical frequencies with a 300 thz femtosecond laser comb,2000,5
Physics,"hall, jl",2005,carrier envelope phase control of femtosecond mode locked lasers and direct optical frequency synthesis,2000,5
Physics,"hansch, tw",2005,direct link between microwave and optical frequencies with a 300 thz femtosecond laser comb,2000,5
Physics,"hansch, tw",2005,quantum phase transition from a superfluid to a mott insulator in a gas of ultracold atoms,2002,3
Physics,"hansch, tw",2005,collapse and revival of the matter wave field of a bose einstein condensate,2002,3
Physics,"wilczek, f",2004,ultraviolet behavior of non abelian gauge theories,1973,31
Physics,"gross, dj",2004,ultraviolet behavior of non abelian gauge theories,1973,31
Physics,"politzer, hd",2004,reliable perturbative results for strong interactions,1973,31
Physics,"abrikosov, aa",2003,magnetic properties of superconductors of the second group,1957,46
Physics,"leggett, aj",2003,quantum tunnelling in a dissipative system,1983,20
Physics,"leggett, aj",2003,the spin dynamics of an anisotropic fermi supefluid 3he,1974,29
Physics,"leggett, aj",2003,can a solid be superfluid,1970,33
Physics,"leggett, aj",2003,interpretation of recent results on sup 3 he below 3 mk a new liquid phase,1972,31
Physics,"leggett, aj",2003,theory of a superfluid fermi liquid i general formalism and static properties,1965,38
Physics,"ginzburg, vl",2003,On the Theory of superconductivity(In Russian),1950,53
Physics,"koshiba, m",2002,observation of a neutrino burst from the supernova sn1987a,1987,15
Physics,"koshiba, m",2002,evidence for oscillation of atmospheric neutrinos,1998,4
Physics,"giacconi, r",2002,evidence for x rays from sources outside the solar system,1962,40
Physics,raymond davis jr.,2002,search for neutrinos from the sun,1968,34
Physics,"cornell, ea",2001,observation of bose einstein condensation in a dilute atomic vapor,1995,6
Physics,"ketterle, w",2001,bose einstein condensation in a gas of sodium atoms,1995,6
Physics,"wiemann, ce",2001,observation of bose einstein condensation in a dilute atomic vapor,1995,6
Physics,kroemer herbert ,2000,heterostructure bipolar transistors and integrated circuits,1982,18
Physics,"alferov, zi",2000,ultranarrow luminescence lines from single quantum dots,1995,5
Physics,"alferov, zi",2000,low threshold large to injection laser emission from inga as quantum dots,1994,6
Physics,"kilby, js",2000,invention of the integrated circuit,1976,24
Physics,"veltman, m",1999,regularization and renormalization of gauge fields,1972,27
Physics,"thooft, g",1999,regularization and renormalization of gauge fields,1972,27
Physics,"stormer, hl",1998,two dimensional magnetotransport in the extreme quantum limit,1982,16
Physics,"tsui, dc",1998,two dimensional magnetotransport in the extreme quantum limit,1982,16
Physics,"laughlin, rb",1998,anomalous quantum hall effect an incompressible quantum fluid with fractionally charged excitations,1983,15
Physics,"phillips, wd",1997,observation of atoms laser cooled below the doppler limit,1988,9
Physics,"cohentannoudji, c",1997,laser cooling below the one photon recoil by velocity selective coherent population trapping,1988,9
Physics,"chu, s",1997,observation of a single beam gradient force optical trap for dielectric particles,1986,11
Physics,"lee, dm",1996,evidence for a new phase of solid he 3,1972,24
Physics,"lee, dm",1996,new magnetic phenomena in liquidhe3below 3 mk,1972,24
Physics,"osheroff, dd",1996,evidence for a new phase of solid he 3,1972,24
Physics,"richards, rc",1996,evidence for a new phase of solid he 3,1972,24
Physics,"richards, rc",1996,new magnetic phenomena in liquidhe3below 3 mk,1972,24
Physics,"perl, ml",1995,discovery of a narrow resonance in e e annihilation,1974,21
Physics,"perl, ml",1995,the discovery of a second narrow resonance in e e annihilation,1974,21
Physics,"perl, ml",1995,evidence for anomalous lepton production in e e annihilation,1975,20
Physics,"reines, f",1995,detection of the free neutrino,1953,42
Physics,"shull, cg",1994,neutron diffraction by paramagnetic and antiferromagnetic substances,1951,43
Physics,"brockhouse, bn",1994,lattice vibrations in silicon and germanium,1959,35
Physics,"brockhouse, bn",1994,normal modes of germanium by neutron spectrometry,1958,36
Physics,"hulse, ra",1993,discovery of a pulsar in a binary system,1975,18
Physics,"taylor, jh",1993,discovery of a pulsar in a binary system,1975,18
Physics,"charpak, g",1992,the use of multiwire proportional counters to select and localize charged particles,1968,24
Physics,"degennes, pg",1991,coil stretch transition of dilute flexible polymers under ultrahigh velocity gradients,1974,17
Physics,"taylor, re",1990,high energy inelastic e p scattering at 6 degrees and 10 degrees,1969,21
Physics,"taylor, re",1990,electron proton elastic scattering at high momentum transfers,1968,22
Physics,"taylor, re",1990,observed behavior of highly inelastic electron proton scattering,1969,21
Physics,"taylor, re",1990,high energy inelastic e p scattering at 6 and 10,1969,21
Physics,"friedman, ji",1990,high energy inelastic e p scattering at 6 degrees and 10 degrees,1969,21
Physics,"friedman, ji",1990,electron proton elastic scattering at high momentum transfers,1968,22
Physics,"friedman, ji",1990,observed behavior of highly inelastic electron proton scattering,1969,21
Physics,"friedman, ji",1990,high energy inelastic e p scattering at 6 and 10,1969,21
Physics,"kendall, hw",1990,high energy inelastic e p scattering at 6 degrees and 10 degrees,1969,21
Physics,"kendall, hw",1990,electron proton elastic scattering at high momentum transfers,1968,22
Physics,"kendall, hw",1990,observed behavior of highly inelastic electron proton scattering,1969,21
Physics,"kendall, hw",1990,measurements of elastic electron deuteron scattering at high momentum transfers,1969,21
Physics,"kendall, hw",1990,high energy inelastic e p scattering at 6 and 10,1969,21
Physics,"ramsey, nf",1989,magnetic shielding of nuclei in molecules,1950,39
Physics,"dehmelt, hg",1989,modulation of a light beam by precessing absorbing atoms,1957,32
Physics,"dehmelt, hg",1989,slow spin relaxation of optically polarized sodium atoms,1957,32
Physics,"dehmelt, hg",1989,spin resonance of free electrons polarized by exchange collisions,1958,31
Physics,"paul, w",1989,notizen ein neues massenspektrometer ohne magnetfeld,1953,36
Physics,"steinberger, j",1988,observation of high energy neutrino reactions and the existence of two kinds of neutrinos,1962,26
Physics,"schwartz, m",1988,observation of high energy neutrino reactions and the existence of two kinds of neutrinos,1962,26
Physics,"lederman, lm",1988,observation of high energy neutrino reactions and the existence of two kinds of neutrinos,1962,26
Physics,"muller, ka",1987,possible high tc superconductivity in the ba la cu o system,1986,1
Physics,"bednorz, jg",1987,possible high tc superconductivity in the ba la cu o system,1986,1
Physics,"binnig, g",1986,surface studies by scanning tunneling microscopy,1982,4
Physics,"binnig, g",1986,scanning tunneling microscopy,1982,4
Physics,"rohrer, h",1986,surface studies by scanning tunneling microscopy,1982,4
Physics,"ruska, e",1986,beitrag zur geometrischen elektronenoptik ii,1932,54
Physics,"vonklitzing, k",1985,new method for high accuracy determination of the fine structure constant based on quantized hall resistance,1980,5
Physics,"rubbia, c",1984,experimental observation of isolated large transverse energy electrons with associated missing energy at sqrt s 540 gev,1983,1
Physics,"rubbia, c",1984,experimental observation of lepton pairs of invariant mass around 95 gev c2 at the cern sps collider,1983,1
Physics,"vandermeer, s",1984,experimental observation of isolated large transverse energy electrons with associated missing energy at sqrt s 540 gev,1983,1
Physics,"vandermeer, s",1984,experimental observation of lepton pairs of invariant mass around 95 gev c2 at the cern sps collider,1983,1
Physics,"fowler, wa",1983,excited states of the mirror nuclei li7 and be7,1951,32
Physics,"chandrasekhar, s",1983,the maximum mass of ideal white dwarfs,1931,52
Physics,"wilson, kg",1982,renormalization group and critical phenomena 2 phase space cell analysis of critical behavior,1971,11
Physics,"wilson, kg",1982,renormalization group and critical phenomena 1 renormalization group and the kadanoff scaling picture,1971,11
Physics,"siegbahn, k",1981, ray spectroscopy in the precision range of 1 105,1956,25
Physics,"schawlow, al",1981,infrared and optical masers,1958,23
Physics,"bloember, n",1981,interactions between light waves in a nonlinear dielectric,1962,19
Physics,"bloember, n",1981,light waves at the boundary of nonlinear media,1962,19
Physics,"cronin, jw",1980,evidence for the 2 pi decay of the k2 0 meson,1964,16
Physics,"fitch, v",1980,evidence for the 2 pi decay of the k2 0 meson,1964,16
Physics,"salam, a",1979,weak and electromagnetic interactions,1968,11
Physics,"weinberg, s",1979,a model of leptons,1967,12
Physics,"glashow, sl",1979,partial symmetries of weak interactions,1961,18
Physics,"kapitza, pl",1978,viscosity of liquid helium below the  point,1938,40
Physics,"wilson, rw",1978,a measurement of excess antenna temperature at 4080 mc s,1965,13
Physics,"penzias, aa",1978,a measurement of excess antenna temperature at 4080 mc s,1965,13
Physics,"mott, n",1977,the basis of the electron theory of metals with special reference to the transition metals,1949,28
Physics,"anderson, pw",1977,absence of diffusion in certain random lattices,1958,19
Physics,"van vleck, jh",1977,theory of the variations in paramagnetic anisotropy among different salts of the iron group,1932,45
Physics,"vanvleck, jh",1977,theory of the variations in paramagnetic anisotropy among different salts of the iron group,1932,45
Physics,"ting, scc",1976,experimental observation of a heavy particle j,1974,2
Physics,"richter, b",1976,discovery of a narrow resonance in e e annihilation,1974,2
Physics,"richter, b",1976,the discovery of a second narrow resonance in e e annihilation,1974,2
Physics,"bohr, a.",1975,interpretation of isomeric transitions of electric quadrupole type,1953,22
Physics,"bohr, a.",1975,rotational states in even even nuclei,1953,22
Physics,"mottelson, br",1975,interpretation of isomeric transitions of electric quadrupole type,1953,22
Physics,"mottelson, br",1975,rotational states in even even nuclei,1953,22
Physics,"rainwater, j",1975,nuclear energy level argument for a spheroidal nuclear model,1950,25
Physics,"ryle, m",1974,solar radiation on 175 mc s,1946,28
Physics,"hewish, a",1974,observation of a rapidly pulsating radio source,1968,6
Physics,"esaki, l",1973,new phenomenon in narrow germanium p n junctions,1958,15
Physics,"giaever, i",1973,tunneling through thin insulating layers,1961,12
Physics,"giaever, i",1973,electron tunneling between two superconductors,1960,13
Physics,"giaever, i",1973,study of superconductors by electron tunneling,1961,12
Physics,"giaever, i",1973,energy gap in superconductors measured by electron tunneling,1960,13
Physics,"josephson, bd",1973,possible new effects in superconductive tunnelling,1962,11
Physics,"schrieffer, jr",1972,theory of superconductivity,1957,15
Physics,"cooper, ln",1972,theory of superconductivity,1957,15
Physics,"bardeen, j",1972,theory of superconductivity,1957,15
Physics,"gabor, d",1971,a new microscopic principle,1948,23
Physics,"gabor, d",1971,microscopy by reconstructed wave fronts,1949,22
Physics,"neel, l",1970,proprietes magnetiques des ferrites ferrimagnetisme et antiferromagnetisme,1948,22
Physics,"alfven, h",1970,on the motion of cosmic rays in interstellar space,1939,31
Physics,"alfven, h",1970,existence of electromagnetic hydrodynamic waves,1942,28
Physics,"gellmann, m",1969,theory of the fermi interaction,1958,11
Physics,"gellmann, m",1969,the axial vector current in beta decay,1960,9
Physics,"gellmann, m",1969,symmetries of baryons and mesons,1962,7
Physics,"alvarez, lw",1968,evidence for a t 0 three pion resonance,1961,7
Physics,"alvarez, lw",1968,catalysis of nuclear reactions by mu mesons,1957,11
Physics,"bethe, ha",1967,energy production in stars,1939,28
Physics,"kastler, a",1966,*quelques suggestions concernant la production optique et la detection optique dune inegalite de population des niveaux de quantification spatiale des atomes - application a lexperience de stern et gerlach et a la resonance magnetique,1950,16
Physics,"feynman, rp",1965,the theory of positrons,1949,16
Physics,"feynman, rp",1965,mathematical formulation of the quantum theory of electromagnetic interaction,1950,15
Physics,"feynman, rp",1965,a relativistic cut off for classical electrodynamics,1948,17
Physics,"feynman, rp",1965,space time approach to quantum electrodynamics,1949,16
Physics,"feynman, rp",1965,relativistic cut off for quantum electrodynamics,1948,17
Physics,"schwinger, j",1965,quantum electrodynamics i a covariant formulation,1948,17
Physics,"schwinger, j",1965,on quantum electrodynamics and the magnetic moment of the electron,1948,17
Physics,"tomonaga, si",1965,on infinite field reactions in quantum field theory,1948,17
Physics,"tomonaga, si",1965,on a relativistically invariant formulation of the quantum theory of wave fields,1949,16
Physics,"prokhorov, am",1964,*primenenie molekulyarnykh puchkov dlya radiospektroskopicheskogo izucheniya vrashchatelnykh spektrov molekul,1954,10
Physics,"townes, ch",1964,infrared and optical masers,1958,6
Physics,"townes, ch",1964,stark effect in rapidly varying fields,1955,9
Physics,"basov, ng",1964,*primenenie molekulyarnykh puchkov dlya radiospektroskopicheskogo izucheniya vrashchatelnykh spektrov molekul,1954,10
Physics,"jensen, jhd",1963,on the magic numbers in nuclear structure,1949,14
Physics,"mayer, mg",1963,on closed shells in nuclei ii,1949,14
Physics,"wigner, ep",1963,on the quantum correction for thermodynamic equilibrium,1932,31
Physics,"wigner, ep",1963,on the interaction of electrons in metals,1934,29
Physics,"landau, l",1962,theory of the superfluidity of helium ii,1941,21
Physics,"mossbauer, rl",1961,kernresonanzabsorption von gammastrahlung in ir191,1958,3
Physics,"mossbauer, rl",1961,kernresonanzfluoreszenz von gammastrahlung in ir191,1958,3
Physics,"hofstadter, r",1961,the detection of gamma rays with thallium activated sodium iodide crystals,1949,12
Physics,"glaser, da",1960,some effects of ionizing radiation on the formation of bubbles in liquids,1952,8
Physics,"chamberlain, o",1959,observation of antiprotons,1955,4
Physics,"segre, e",1959,observation of antiprotons,1955,4
Physics,"cherenkov, pa",1958,Visible emission of clean liquids by action of  radiation,1934,24
Physics,"tamm, i",1958,coherent visible radiation from fast electrons passing through matter,1937,21
Physics,"frank, i",1958,coherent visible radiation of fast electrons passing through matter,1937,21
Physics,"lee, td",1957,question of parity conservation in weak interactions,1956,1
Physics,"yang, cn",1957,question of parity conservation in weak interactions,1956,1
Physics,"bardeen, j",1956,surface states and rectification at a metal semi conductor contact,1947,9
Physics,"brattain, wh",1956,the transistor a semi conductor triode,1948,8
Physics,"shockley, w",1956,the theory of p n junctions in semiconductors and p n junction transistors,1949,7
Physics,"shockley, w",1956,deformation potentials and mobilities in non polar crystals,1950,6
Physics,"kusch, p",1955,the magnetic moment of the electron,1948,7
Physics,"lamb, we",1955,fine structure of the hydrogen atom by a microwave method,1947,8
Physics,"born, m",1954,zur quantenmechanik der stosvorgange,1926,28
Physics,"born, m",1954,quantenmechanik der stosvorgange,1926,28
Physics,"born, m",1954,beweis des adiabatensatzes,1928,26
Physics,"born, m",1954,zur quantenmechanik ii,1926,28
Physics,"born, m",1954,on the quantum theory of molecules,1927,27
Physics,"bothe, w",1954,uber das wesen des comptoneffekts ein experimenteller beitrag zur theorie der strahlung,1925,29
Physics,"zernike, f",1953,diffraction theory of the knife edge test and its improved form the phase contrast method,1934,19
Physics,"bloch, f",1952,the nuclear induction experiment,1946,6
Physics,"purcell, em",1952,resonance absorption by nuclear magnetic moments in a solid,1946,6
Physics,"walton, ets",1951,experiments with high velocity positive ions ii the disintegration of elements by high velocity protons,1932,19
Physics,"cockcroft, jd",1951,experiments with high velocity positive ions ii the disintegration of elements by high velocity protons,1932,19
Physics,"powell, cf",1950,observations on the tracks of slow mesons in photographic emulsions,1947,3
Physics,"powell, cf",1950,processes involving charged mesons,1947,3
Physics,"yukawa, h",1949,on the nuclear transformation with the absorption of the orbital electron,1937,12
Physics,"yukawa, h",1949,mass and mean life time of the meson,1939,10
Physics,"blackett, pms",1948,further investigations with a wilson chamber ii the range and velocity of recoil atoms,1932,16
Physics,"blackett, pms",1948,some photographs of the tracks of penetrating radiation,1933,15
Physics,"appleton, ev",1947,local reflection of wireless waves from the upper atmosphere,1925,22
Physics,"appleton, ev",1947,on some direct evidence for downward atmospheric reflection of electric rays,1925,22
Physics,"bridgman, pw",1946,the coagulation of albumen by pressure,1914,32
Physics,"bridgman, pw",1946,change of phase under pressure i the phase diagram of eleven substances with especial reference to the melting curve,1914,32
Physics,"bridgman, pw",1946,two new modifications of phosphorus,1914,32
Physics,"pauli, w",1945,uber den zusammenhang des abschlusses der elektronengruppen im atom mit der komplexstruktur der spektren,1925,20
Physics,"rabi, ii",1944,a new method of measuring nuclear magnetic moment,1938,6
Physics,"stern, o",1943,der experimentelle nachweis des magnetischen moments des silberatoms,1922,21
Physics,"stern, o",1943,the magnetic moment of silver atoms,1922,21
Physics,"lawrence, eo",1939,the production of high speed light ions without the use of high voltages,1931,8
Physics,"lawrence, eo",1939,the production of heavy high speed ions without the use of high voltages,1931,8
Physics,"fermi, e",1938,an attempt of a theory of beta radiation 1,1934,4
Physics,"davisson, cj",1937,diffraction of electrons by a crystal of nickel,1927,10
Physics,"thomson, gp",1937,diffraction of cathode rays by a thin film,1927,10
Physics,victor f. hess,1936,observations in low level radiation during seven free balloon flights.,1912,24
Physics,"anderson, cd",1936,the positive electron,1933,3
Physics,"chadwick, j",1935,possible existence of a neutron,1932,3
Physics,"schrodinger, e",1933,der stetige ubergang von der mikro zur makromechanik,1926,7
Physics,"schrodinger, e",1933,an undulatory theory of the mechanics of atoms and molecules,1926,7
Physics,"schrodinger, e",1933,uber das verhaltnis der heisenberg born jordanschen quantenmechanik zu der meinem,1926,7
Physics,"schrodinger, e",1933,quantisierung als eigenwertproblem,1926,7
Physics,"dirac, pam",1933,the quantum theory of the electron,1928,5
Physics,"heisenberg, w",1932,zur theorie des ferromagnetismus,1928,4
Physics,"raman, cv",1930,a new type of secondary radiation,1928,2
Physics,"broglie, ld",1929,xxxv a tentative theory of light quanta,1924,5
Physics,"richardson, ow",1928,on the negative radiation from hot platinum,1901,27
Physics,"compton, ah",1927,the spectrum of scattered x rays,1923,4
Physics,"compton, ah",1927,a quantum theory of the scattering of x rays by light elements,1923,4
Physics,"compton, ah",1927,cxvii the total reflexion of x rays,1923,4
Physics,"wilson, ctr",1927,on a method of making visible the paths of ionising particles through a gas,1911,16
Physics,"perrin, j",1926,sur la theorie du mouvement brownien,1908,18
Physics,gustav hertz,1925,the kinetics of electrons and ions in gases,1916,9
Physics,gustav hertz,1925,the confirmation of the bohr atomic theory in the optical spectra by means of experiments of the unelastic impacts of slow electrons with gas molecules,1919,6
Physics,"franck, j",1925,the kinetics of electrons and ions in gases,1916,9
Physics,"franck, j",1925,the confirmation of the bohr atomic theory in the optical spectra by means of experiments of the unelastic impacts of slow electrons with gas molecules,1919,6
Physics,"siegbahn, m",1924,the x-ray spectrum of the elements na to cr,1916,8
Physics,"siegbahn, m",1924,on the high-frequency spectra (k-series) of elements cr to ge.,1916,8
Physics,"siegbahn, m",1924,on a vacuum spectrograph for the registration of high-frequence spectra and a preliminary testing of rare soils with the same.,1916,8
Physics,"millikan, ra",1923,the isolation of an ion a precision measurement of its charge and the correction of stokes s law,1910,13
Physics,"millikan, ra",1923,a new modification of the cloud method of measuring the elementary electrical charge and the most probable value of that charge,1910,13
Physics,"bohr, n",1922,i on the constitution of atoms and molecules,1913,9
Physics,"bohr, n",1922,xxxvii on the constitution of atoms and molecules,2009,-87
Physics,"bohr, n",1922,lxxiii on the constitution of atoms and molecules,1913,9
Physics,"bohr, n",1922,ii on the theory of the decrease of velocity of moving electrified particles on passing through matter,1913,9
Physics,"einstein, a",1921,uber einen die erzeugung und verwandlung des lichtes betreffenden heuristischen gesichtspunkt,1905,16
Physics,"einstein, a",1921,zur elektrodynamik bewegter korper,1905,16
Physics,"einstein, a",1921,on the movement of small particles suspended in a stationary liquid demanded by the molecular kinetic theory of heart,1905,16
Physics,charles edouard guillaume,1920,The Anomaly of the Nickel-Steels,1919,1
Physics,"stark, j",1919,beobachtungen uber den effekt des elektrischen feldes auf spektrallinien ii langseffekt,1914,5
Physics,"planck, m",1918,Ueber das Gesetz der Energieverteilung im Normalspectrum,1901,17
Physics,"barkla, cg",1917,polarisation in secondary rontgen radiation,1906,11
Physics,"bragg, wl",1915,the reflection of x rays by crystals,1913,2
Physics,"bragg, wl",1915,the structure of some crystals as indicated by their diffraction of x rays,1913,2
Physics,"bragg, wh",1915,the reflection of x rays by crystals,1913,2
Physics,"laue, m",1914,interferenzerscheinungen bei rontgenstrahlen,1913,1
Physics,"onnes, hk",1913,"further experiments with liquid helium d - on the change of the electrical resistance of pure metals at very low temperatures, etc v the disappearance of the resistance of mercury",1911,2
Physics,"wien, w",1911,Wien's displacement law,1983,-72
Physics,albert a. michelson,1907,On the Relative Motion of the Earth and the Luminiferous Ether,1887,20
Physics,joseph john thomson,1906,XL. Cathode Rays,1897,9
Physics,"lenard, p",1905,Ueber Kathodenstrahlen in Gasen von atmosphrischem Druck und im ussersten Vacuum,1894,11
Physics,"zeeman, p",1902,The Effect of Magnetisation on the Nature of Light Emitted by a Substance,1897,5
Physics,"zeeman, p",1902,The Influence of a Magnetic Field on Radiation Frequency,1896,6
Chemistry,"stoddart, j",2016,a molecular shuttle,1991,25
Chemistry,"feringa, b",2016,light driven monodirectional molecular rotor,1999,17
Chemistry,"sauvage, j",2016,une nouvelle famille de molecules les metallo catenanes,1983,33
Chemistry,"modrich, p",2015,dna mismatch correction in a defined system,1989,26
Chemistry,"lindahl, t",2015,an n glycosidase from escherichia coli that releases free uracil from dna containing deaminated cytosine residues,1974,41
Chemistry,"sancar, a",2015,a novel repair enzyme uvrabc excision nuclease of escherichia coli cuts a dna strand on both sides of the damaged region,1983,32
Chemistry,"moerner, w",2014,single photons on demand from a single molecule at room temperature,2000,14
Chemistry,"betzig, e",2014,breaking the diffraction barrier optical microscopy on a nanometric scale,1991,23
Chemistry,"betzig, e",2014,near field optics microscopy spectroscopy and surface modification beyond the diffraction limit,1992,22
Chemistry,"betzig, e",2014,single molecules observed by near field scanning optical microscopy,1993,21
Chemistry,"hell, s",2014,breaking the diffraction resolution limit by stimulated emission stimulated emission depletion fluorescence microscopy,1994,20
Chemistry,"levitt, m",2013,computer simulation of protein folding,1975,38
Chemistry,"levitt, m",2013,theoretical studies of enzymic reactions dielectric electrostatic and steric stabilization of the carbonium ion in the reaction of lysozyme,1976,37
Chemistry,"warshel, a",2013,computer simulation of protein folding,1975,38
Chemistry,"warshel, a",2013,calculation of ground and excited state potential surfaces of conjugated molecules i formulation and parametrization,1972,41
Chemistry,"warshel, a",2013,theoretical studies of enzymic reactions dielectric electrostatic and steric stabilization of the carbonium ion in the reaction of lysozyme,1976,37
Chemistry,"karplus, m",2013,calculation of ground and excited state potential surfaces of conjugated molecules i formulation and parametrization,1972,41
Chemistry,"lefkowitz, r",2012,cloning of the gene and cdna for mammalian  adrenergic receptor and homology with rhodopsin,1986,26
Chemistry,"kobilka, b",2012,cloning of the gene and cdna for mammalian  adrenergic receptor and homology with rhodopsin,1986,26
Chemistry,"shechtman, d",2011,metallic phase with long range orientational order and no translational symmetry,1984,27
Chemistry,"heck, r",2010,palladium catalyzed vinylic hydrogen substitution reactions with aryl benzyl and styryl halides,1972,38
Chemistry,"heck, r",2010,acylation methylation and carboxyalkylation of olefins by group viii metal derivatives,1968,42
Chemistry,"heck, r",2010,allylation of aromatic compounds with organopalladium salts,1968,42
Chemistry,"heck, r",2010,the palladium catalyzed arylation of enol esters ethers and halides a new synthesis of 2 aryl aldehydes and ketones,1968,42
Chemistry,"heck, r",2010,the arylation of allylic alcohols with organopalladium compounds a new synthesis of 3 aryl aldehydes and ketones,1968,42
Chemistry,"negishi, e",2010,a novel stereospecific alkenyl alkenyl cross coupling by a palladium or nickel catalyzed reaction of alkenylalanes with alkenyl halides,1976,34
Chemistry,"negishi, e",2010,novel stereoselective alkenyl aryl coupling via nickel catalysed reaction of alkenylanes with aryl halides,1976,34
Chemistry,"suzuki, a",2010,a new stereospecific cross coupling by the palladium catalyzed reaction of 1 alkenylboranes with 1 alkenyl or 1 alkynyl halides,1979,31
Chemistry,"ramakrishnan, v",2009,structure of the 30s ribosomal subunit,2000,9
Chemistry,"ramakrishnan, v",2009,functional insights from the structure of the 30s ribosomal subunit and its interactions with antibiotics,2000,9
Chemistry,"steitz, t",2009,the complete atomic structure of the large ribosomal subunit at 2,2000,9
Chemistry,"steitz, t",2009,the complete atomic structure of the large ribosomal subunit at 2 4 a resolution,2000,9
Chemistry,"steitz, t",2009,the structural basis of ribosome activity in peptide bond synthesis,2000,9
Chemistry,"yonath, a",2009,structure of functionally activated small ribosomal subunit at 3 3 a resolution,2000,9
Chemistry,"chalfie, m",2008,green fluorescent protein as a marker for gene expression,1994,14
Chemistry,"tsien, r",2008,fluorescent indicators for ca2 based on green fluorescent proteins and calmodulin,1997,11
Chemistry,"tsien, r",2008,improved green fluorescence,1995,13
Chemistry,"tsien, r",2008,wavelength mutations and posttranslational autoxidation of green fluorescent protein,1994,14
Chemistry,"tsien, r",2008,understanding improving and using green fluorescent proteins,1995,13
Chemistry,"tsien, r",2008,crystal structure of the aequorea victoria green fluorescent protein,1996,12
Chemistry,shimomur.o,2008,extraction purification and properties of aequorin a bioluminescent protein from the luminous hydromedusan aequorea,1962,46
Chemistry,"ertl, g",2007,adsorption of co on pd single crystal surfaces,1974,33
Chemistry,"ertl, g",2007,a molecular beam investigation of the catalytic oxidation of co on pd 111,1978,29
Chemistry,"ertl, g",2007,adsorption of hydrogen on palladium single crystal surfaces,1974,33
Chemistry,"ertl, g",2007,adsorption of hydrogen on nickel single crystal surfaces,1974,33
Chemistry,"ertl, g",2007,adsorption of hydrogen on a pt 111 surface,1976,31
Chemistry,"ertl, g",2007,chemisorption of co on the pt 111 surface,1977,30
Chemistry,"kornberg, r",2006,chromatin structure a repeating unit of histones and dna,1974,32
Chemistry,"chauvin, y",2005,catalyse de transformation des olefines par les complexes du tungstene ii telomerisation des olefines cycliques en presence d olefines acycliques,1971,34
Chemistry,"grubbs, r",2005,ring opening metathesis polymerization romp of norbornene by a group viii carbene complex in protic media,1992,13
Chemistry,"grubbs, r",2005,syntheses and activities of new single component ruthenium based olefin metathesis catalysts,1993,12
Chemistry,"schrock, r",2005,synthesis of molybdenum imido alkylidene complexes and some reactions involving acyclic olefins,1990,15
Chemistry,"schrock, r",2005,living ring opening metathesis polymerization catalyzed by well characterized transition metal alkylidene complexes,1990,15
Chemistry,"ciechanover, a",2004,proposed role of atp in protein breakdown conjugation of protein with multiple chains of the polypeptide of atp dependent proteolysis,1980,24
Chemistry,"ciechanover, a",2004,atp dependent conjugation of reticulocyte proteins with the polypeptide required for protein degradation,1980,24
Chemistry,"hershko, a",2004,proposed role of atp in protein breakdown conjugation of protein with multiple chains of the polypeptide of atp dependent proteolysis,1980,24
Chemistry,"hershko, a",2004,atp dependent conjugation of reticulocyte proteins with the polypeptide required for protein degradation,1980,24
Chemistry,"rose, i",2004,proposed role of atp in protein breakdown conjugation of protein with multiple chains of the polypeptide of atp dependent proteolysis,1980,24
Chemistry,"agre, p",2003,appearance of water channels in xenopus oocytes expressing red cell chip28 water channel,1992,11
Chemistry,"mackinnon, r",2003,the structure of the potassium channel molecular basis of k conduction and selectivity,1998,5
Chemistry,"wuthrich, k",2002,solution conformation of proteinase inhibitor iia from bull seminal plasma by 1h nuclear magnetic resonance and distance geometry,1985,17
Chemistry,"tanaka, k",2002,Protein and polymer analyses up to m/z 100 000 by laser ionization timeofflight mass spectrometry,1988,14
Chemistry,"fenn, j",2002,electrospray ionization for mass spectrometry of large biomolecules,1989,13
Chemistry,"noyori, r",2001,homogeneous catalysis in the decomposition of diazo compounds by copper chelates asymmetric carbenoid reactions,1968,33
Chemistry,"knowles, w",2001,catalytic asymmetric hydrogenation employing a soluble optically active rhodium complex,1968,33
Chemistry,"sharpless, k",2001,the first practical method for asymmetric epoxidation,1980,21
Chemistry,"heeger, a",2000,electrical conductivity in doped polyacetylene,1977,23
Chemistry,"heeger, a",2000,synthesis of electrically conducting organic polymers halogen derivatives of polyacetylene ch x,1977,23
Chemistry,shirakaw.h,2000,electrical conductivity in doped polyacetylene,1977,23
Chemistry,shirakaw.h,2000,synthesis of electrically conducting organic polymers halogen derivatives of polyacetylene ch x,1977,23
Chemistry,"macdiarmid, a",2000,electrical conductivity in doped polyacetylene,1977,23
Chemistry,"macdiarmid, a",2000,synthesis of electrically conducting organic polymers halogen derivatives of polyacetylene ch x,1977,23
Chemistry,"zewail, a",1999,femtosecond real time observation of wave packet oscillations resonance in dissociation reactions,1988,11
Chemistry,"pople, j",1998,the influence of polarization functions on molecular orbital hydrogenation energies,1973,25
Chemistry,"kohn, w",1998,inhomogeneous electron gas,1964,34
Chemistry,"kohn, w",1998,self consistent equations including exchange and correlation effects,1965,33
Chemistry,"boyer, p",1997,spectrophotometric study of the reaction of protein sulfhydryl groups with organic mercurials,1954,43
Chemistry,"walker, j",1997,structure at 2 8 a resolution of f1 atpase from bovine heart mitochondria,1994,3
Chemistry,"skou, j",1997,the influence of some cations on an adenosine triphosphatase from peripheral nerves,1957,40
Chemistry,"kroto, h",1996,c 60 buckminsterfullerene,1985,11
Chemistry,"smalley, r",1996,c 60 buckminsterfullerene,1985,11
Chemistry,"curl, r",1996,c 60 buckminsterfullerene,1985,11
Chemistry,"molina, m",1995,stratospheric sink for chlorofluoromethanes chlorine atomc atalysed destruction of ozone,1974,21
Chemistry,"crutzen, p",1995,the influence of nitrogen oxides on the atmospheric ozone content,1970,25
Chemistry,"rowland, f",1995,stratospheric sink for chlorofluoromethanes chlorine atomc atalysed destruction of ozone,1974,21
Chemistry,"olah, g",1994,stable carbonium ions ii 1aoxocarbonium1b acylium tetrafluoroborates hexafluorophosphates hexafluoroantimonates and hexafluoroarsenates structure and chemical reactivity of acyl fluoride lewis acid fluoride complexes1c,1962,32
Chemistry,"smith, m",1993,nucleotide sequence of bacteriophage phi x174 dna,1977,16
Chemistry,"smith, m",1993,the nucleotide sequence of bacteriophage x174,1978,15
Chemistry,"smith, m",1993,oligonucleotide directed mutagenesis using m13 derived vectors an efficient and general procedure for the production of point mutations in any fragment of dna,1982,11
Chemistry,"mullis, k",1993,primer directed enzymatic amplification of dna with a thermostable dna polymerase,1988,5
Chemistry,"mullis, k",1993,enzymatic amplification of beta globin genomic sequences and restriction site analysis for diagnosis of sickle cell anemia,1985,8
Chemistry,"marcus, r",1992,on the theory of oxidation reduction reactions involving electron transfer i,1956,36
Chemistry,"ernst, r",1991,two dimensional spectroscopy application to nuclear magnetic resonance,1976,15
Chemistry,"ernst, r",1991,application of fourier transform spectroscopy to magnetic resonance,1966,25
Chemistry,"ernst, r",1991,investigation of exchange processes by two dimensional nmr spectroscopy,1979,12
Chemistry,"corey, e",1990,the stereochemistry of complex inorganic compounds xxii stereospecific effects in complex ions1,1959,31
Chemistry,"cech, t",1989,self splicing rna autoexcision and autocyclization of the ribosomal rna intervening sequence of tetrahymena,1982,7
Chemistry,"altman, s",1989,the rna moiety of ribonuclease p is the catalytic subunit of the enzyme,1983,6
Chemistry,"deisenhofer, j",1988,x ray structure analysis of a membrane protein complex electron density map at 3 a resolution and a model of the chromophores of the photosynthetic reaction center from rhodopseudomonas viridis,1984,4
Chemistry,"deisenhofer, j",1988,structure of the protein subunits in the photosynthetic reaction centre of rhodopseudomonas viridis at 3a resolution,1985,3
Chemistry,"huber, r",1988,x ray structure analysis of a membrane protein complex electron density map at 3 a resolution and a model of the chromophores of the photosynthetic reaction center from rhodopseudomonas viridis,1984,4
Chemistry,"huber, r",1988,structure of the protein subunits in the photosynthetic reaction centre of rhodopseudomonas viridis at 3a resolution,1985,3
Chemistry,"michel, h",1988,three dimensional crystals of a membrane protein complex the photosynthetic reaction centre from rhodopseudomonas viridis,1982,6
Chemistry,"michel, h",1988,x ray structure analysis of a membrane protein complex electron density map at 3 a resolution and a model of the chromophores of the photosynthetic reaction center from rhodopseudomonas viridis,1984,4
Chemistry,"michel, h",1988,structure of the protein subunits in the photosynthetic reaction centre of rhodopseudomonas viridis at 3a resolution,1985,3
Chemistry,"cram, d",1987,studies in stereochemistry x the rule of steric control of asymmetric induction in the syntheses of acyclic systems,1952,35
Chemistry,"lehn, j",1987,diaza polyoxa macrocycles et macrobicycles,1969,18
Chemistry,"pedersen, c",1987,cyclic polyethers and their complexes with metal salts,1967,20
Chemistry,"polanyi, j",1986,location of energy barriers i effect on the dynamics of reactions a bc,1969,17
Chemistry,"polanyi, j",1986,concepts in reaction dynamics,1972,14
Chemistry,herschba.dr,1986,molecular beam reactive scattering apparatus with electron bombardment detector,1969,17
Chemistry,herschba.dr,1986,combination rules for van der waals force constants,1970,16
Chemistry,"lee, y",1986,crossed molecular beam study of f c2h4 c2d4,1972,14
Chemistry,"lee, y",1986,intermolecular potentials from crossed beam differential elastic scattering measurements iv ar ar,1972,14
Chemistry,"lee, y",1986,molecular beam reactive scattering apparatus with electron bombardment detector,1969,17
Chemistry,"karle, j",1985,a theory of phase determination for the four types of non centrosymmetric space groups 1p222 2p22 3p12 3p22,1956,29
Chemistry,"hauptman, h",1985,a theory of phase determination for the four types of non centrosymmetric space groups 1p222 2p22 3p12 3p22,1956,29
Chemistry,merrifie.rb,1984,solid phase peptide synthesis i the synthesis of a tetrapeptide,1963,21
Chemistry,"taube, h",1983,rates and mechanisms of substitution in inorganic complexes in solution,1952,31
Chemistry,"klug, a",1982,reconstruction of three dimensional structures from electron micrographs,1968,14
Chemistry,"klug, a",1982,physical principles in the construction of regular viruses,1962,20
Chemistry,"fukui, k",1981,a molecular orbital theory of reactivity in aromatic hydrocarbons,1952,29
Chemistry,"hoffmann, r",1981,an extended huckel theory i hydrocarbons,1963,18
Chemistry,"hoffmann, r",1981,the conservation of orbital symmetry,1969,12
Chemistry,"hoffmann, r",1981,selection rules for concerted cycloaddition reactions,1965,16
Chemistry,"hoffmann, r",1981,stereochemistry of electrocyclic reactions,1965,16
Chemistry,"hoffmann, r",1981,selection rules for sigmatropic reactions,1965,16
Chemistry,"gilbert, w",1980,a new method for sequencing dna,1977,3
Chemistry,"sanger, f",1980,dna sequencing with chain terminating inhibitors,1977,3
Chemistry,"berg, p",1980,labeling deoxyribonucleic acid to high specific activity in vitro by nick translation with dna polymerase i,1977,3
Chemistry,"wittig, g",1979,zur reaktionsweise des pentaphenyl phosphors und einiger derivate,1953,26
Chemistry,"wittig, g",1979,uber triphenyl phosphin methylene als olefinbildende reagenzien i mitteil,1954,25
Chemistry,"brown, h",1979,directive effects in aromatic substitution .30. electrophilic substituent constants,1958,21
Chemistry,"mitchell, p",1978,Coupling of phosphorylation to electron and hydrogen transfer by a chemi-osmotic type of mechanism.,1961,17
Chemistry,"prigogine, i",1977,dynamical and statistical descriptions of n body systems,1969,8
Chemistry,"lipscomb, w",1976,coupling of phosphorylation to electron and hydrogen transfer by a chemi osmotic type of mechanism,1961,15
Chemistry,"lipscomb, w",1976,theory of polyhedral molecules i physical factorizations of the secular equation,1962,14
Chemistry,"lipscomb, w",1976,boron hydrides lcao mo and resonance studies,1962,14
Chemistry,"lipscomb, w",1976,theory of polyhedral molecules iii population analyses and reactivities for the carboranes,1962,14
Chemistry,"prelog, v",1975,description of steric relationships across single bonds,1960,15
Chemistry,"prelog, v",1975,the specification of asymmetric configuration in organic chemistry,1956,19
Chemistry,"prelog, v",1975,specification of molecular chirality,1966,9
Chemistry,cornfort.jw,1975,studies on the biosynthesis of cholesterol xvi chemical synthesis of 1 h2 3 2 c 14 and 1 d2 2 c 14 trans trans farnesyl pyrophosphate and their utilization in squalene biosynthesis,1962,13
Chemistry,"flory, p",1974,molecular size distribution in linear condensation polymers1,1936,38
Chemistry,"flory, p",1974,the mechanism of vinyl polymerizations1,1937,37
Chemistry,wilkinso.g,1973,the structure of iron bis cyclopentadienyl,1952,21
Chemistry,"fischer, e",1973,cyclopentadien metallkomplexe ein neuer typ metallorganischer verbindungen,1952,21
Chemistry,"anfinsen, c",1972,the kinetics of formation of native ribonuclease during oxidation of the reduced polypeptide chain,1961,11
Chemistry,"stein, w",1972,automatic recording apparatus for use in the chromatography of amino acids,1958,14
Chemistry,"stein, w",1972,chromatography of amino acids on sulfonated polystyrene resins an improved system,1958,14
Chemistry,"moore, s",1972,automatic recording apparatus for use in the chromatography of amino acids,1958,14
Chemistry,"herzberg, g.",1971,absorption spectrum of free ch3 and cd3 radicals,1956,15
Chemistry,"herzberg, g.",1971,the bakerian lecture the spectra and structures of free methyl and free methylene,1961,10
Chemistry,"herzberg, g.",1971,the lyman bands of molecular hydrogen,1959,12
Chemistry,"herzberg, g.",1971,analysis of the 4050 a group of the c 3 molecule,1965,6
Chemistry,"herzberg, g.",1971,the spectrum and structure of singlet ch 2,1966,5
Chemistry,"leloir, l",1970,a modified colorimetric method for the estimation of n acetylamino sugars,1955,15
Chemistry,"barton, d",1969,the principles of conformational analysis,1956,13
Chemistry,"hassel, o",1969,the structure of molecules containing cyclohexane or pyranose rings,1947,22
Chemistry,"onsager, l",1968,reciprocal relations in irreversible processes ii,1931,37
Chemistry,"norrish, r",1967,chemical reactions produced by very high light intensities,1949,18
Chemistry,"porter, g",1967,chemical reactions produced by very high light intensities,1949,18
Chemistry,"eigen, m",1967,uber die kinetik sehr schnell verlaufender ionenreaktionen in wasseriger losung,1954,13
Chemistry,"mulliken, r",1966,electronic population analysis on lcao mo molecular wave functions i,1955,11
Chemistry,"woodward, r",1965,the mechanism of the diels alder reaction,1959,6
Chemistry,"woodward, r",1965,cis hydroxylation of a synthetic steroid intermediate with iodine silver acetate and wet acetic acid,1958,7
Chemistry,"woodward, r",1965,the total synthesis of steroids1,1952,13
Chemistry,"hodgkin, d",1964,structure of vitamin b12,1956,8
Chemistry,"ziegler, k",1963,polymerisation von athylen und anderen olefinen,1955,8
Chemistry,"natta, g",1963,crystalline high polymers of  olefins,1955,8
Chemistry,"kendrew, j",1962,a three dimensional model of the myoglobin molecule obtained by x ray analysis,1958,4
Chemistry,"kendrew, j",1962,structure of myoglobin a three dimensional fourier synthesis at 2 a resolution,1960,2
Chemistry,"perutz, m",1962,structure of haemoglobin a three dimensional fourier synthesis at 5 5 a resolution obtained by x ray analysis,1960,2
Chemistry,"calvin, m",1961,the path of carbon in photosynthesis xx the steady state,1952,9
Chemistry,"calvin, m",1961,the path of carbon in photosynthesis v paper chromatography and radioautography of the products,1950,11
Chemistry,"calvin, m",1961,the path of carbon in photosynthesis vii respiration and photosynthesis,1950,11
Chemistry,"libby, w",1960,age determination by radiocarbon content world wide assay of natural radiocarbon,1949,11
Chemistry,"heyrovsky, j",1959,researches with the dropping mercury cathode part ii the polarograph,2010,-51
Chemistry,"heyrovsky, j",1959,the processes at the mercury dropping cathode part i the deposition of metals,1924,35
Chemistry,"sanger, f",1958,disulphide interchange reactions,1955,3
Chemistry,"sanger, f",1958,the free amino groups of insulin,1945,13
Chemistry,"sanger, f",1958,the disulphide bonds of insulin,1955,3
Chemistry,"todd, a",1957,studies on phosphorylation .1. dibenzyl chlorophosphonate as a phosphorylating agent,1945,12
Chemistry,"todd, a",1957,studies on phosphorylation .2. the reaction of dialkyl phosphites with polyhalogen compounds in presence of bases - a new method for the phosphorylation of amines,1945,12
Chemistry,"hinshelwood, c",1956,227 on the factors determining the velocity of reactions in solution molecular statistics of the benzoylation of amines,1934,22
Chemistry,"hinshelwood, c",1956,further investigations on the kinetics of gaseous oxidation reactions,1930,26
Chemistry,"hinshelwood, c",1956,333 the activation energy of organic reactions part iv transmission of substituent influences in ester hydrolysis,1938,18
Chemistry,n. n. semenov,1956,Chemical kinetics and chain reactions,1935,21
Chemistry,"duvigneaud, v",1955,the synthesis of an octapeptide amide with the hormonal activity of oxytocin,1953,2
Chemistry,"duvigneaud, v",1955,the synthesis of oxytocin1,1954,1
Chemistry,"pauling, l",1954,the structure of proteins two hydrogen bonded helical configurations of the polypeptide chain,1951,3
Chemistry,"staudinger, h",1953,uber neue organische phosphorverbindungen iii phosphinmethylenderivate und phosphinimine,1919,34
Chemistry,"staudinger, h",1953,einwirkungen von aliphatischen diazoverbindungen auf thioketone,1920,33
Chemistry,"staudinger, h",1953,uber neue organische phosphorverbindungen iv phosphinimine,1921,32
Chemistry,"synge, r",1952,a new form of chromatogram employing two liquid phases a theory of chromatography 2 application to the micro determination of the higher monoamino acids in proteins,1941,11
Chemistry,"martin, a",1952,a new form of chromatogram employing two liquid phases a theory of chromatography 2 application to the micro determination of the higher monoamino acids in proteins,1941,11
Chemistry,"seaborg, g",1951,radioactive element 94 from deuterons on uranium,1946,5
Chemistry,"mcmillan, e",1951,radioactive element 93,1940,11
Chemistry,"alder, k",1950,synthesen in der hydroaromatischen reihe,1928,22
Chemistry,"diels, o",1950,synthesen in der hydroaromatischen reihe,1928,22
Chemistry,"giauque, w",1949,attainment of temperatures below 1 absolute by demagnetization ofgd2 so4 3 8h2o,1933,16
Chemistry,"tiselius, a",1948,electrophoresis of serum globulin electrophoretic analysis of normal and immune sera,1937,11
Chemistry,"tiselius, a",1948,an electrophoretic study of immune sera and purified antibody preparations,1939,9
Chemistry,"tiselius, a",1948,a new apparatus for electrophoretic analysis of colloidal mixtures,1937,11
Chemistry,"robinson, r",1947,lxxv a theory of the mechanism of the phytochemical synthesis of certain alkaloids,1917,30
Chemistry,"stanley, w",1946,the inactivation of crystalline tobacco mosaic virus protein,1936,10
Chemistry,"stanley, w",1946,chemical studies on the virus of tobacco mosaic vi the isolation from diseased turkish tobacco plants of a crystalline protein possessing the properties of tobacco mosaic virus,1936,10
Chemistry,"northrop, j",1946,a method for the determination of diffusion constants and the calculation of the radius and weight of the hemoglobin molecule,1929,17
Chemistry,"sumner, j",1946,the isolation and crystallization of the enzyme urease preliminary paper,1926,20
Chemistry,"virtanen, a",1945,the enzymatic fission and synthesis of asparaginic acid.,1932,13
Chemistry,"hahn, o",1944,uber den nachweis und das verhalten der bei der bestrahlung des urans mittels neutronen entstehenden erdalkalimetalle,1939,5
Chemistry,"hevesy, g",1943,the absorption and translocation of lead by plants a contribution to the application of the method of radioactive indicators in the investigation of the change of substance in plants,1923,20
Chemistry,"ruzicka, l",1939,hohere terpenverbindungen viii uber die konstitution des nerolidols peruviol,1923,16
Chemistry,"ruzicka, l",1939,hohere terpenverbindungen xxiv ringbildungen bei sesquiterpenen totalsynthese des bisabolens und eines hexahydro cadalins,1925,14
Chemistry,"ruzicka, l",1939,hohere terpenverbindungen ix uber die totalsynthese des d l nerolidols und des farnesols,1923,16
Chemistry,"ruzicka, l",1939,uber androstendion einen hochwirksamen mannlichen pragungsstoff ein beitrag zur genese der keimdrusenhormone,1935,4
Chemistry,"butenandt, a",1939,notiz uber ein isomeres allo pregnanol 3 on 20,1935,4
Chemistry,"butenandt, a",1939,uberfuhrung des pregnandiols in corpus luteum hormon,1934,5
Chemistry,"butenandt, a",1939,zur isolierung und charakterisierung des corpus luteum hormons,1934,5
Chemistry,"butenandt, a",1939,uber testosteron umwandlung des dehydro androsterons in androstendiol und testosteron ein weg zur darstellung des testosterons aus cholesterin,1935,4
Chemistry,"butenandt, a",1939,uber androsteron iii isolierung eines neuen physiologisch unwirksamen sterinderivates aus mannerharn seine verknupfung mit dehydro androsteron und androsteron ein beitrag zur konstitution des androsterons,1934,5
Chemistry,"kuhn, r",1938,mikro bestimmung von acetyl benzoyl und c methylgruppen,1933,5
Chemistry,"haworth, w",1937,lxxxiii polysaccharides part i the structure of inulin,1928,9
Chemistry,"haworth, w",1937,the structure of carbohydrates,1928,9
Chemistry,"karrer, p",1937,zur kenntnis des vitamins a aus fischtranen,1931,6
Chemistry,"debye, p",1936,zur theorie der spezifischen warmen,1912,24
Chemistry,"joliot, f",1935,artificial production of a new kind of radio element,1934,1
Chemistry,"curie, i",1935,. Production artificielle d'lments radioactifs - II. Preuve chimique de la transmutation des lments,1934,1
Chemistry,"urey, h",1934,a hydrogen isotope of mass 2,1932,2
Chemistry,"langmuir, i",1932,the adsorption of gases on plane surfaces of glass mica and platinum,1918,14
Chemistry,"langmuir, i",1932,the constitution and fundamental properties of solids and liquids,1917,15
Chemistry,"langmuir, i",1932,the constitution and fundamental properties of solids and liquids part ii liquids,1917,15
Chemistry,"langmuir, i",1932,the constitution and fundamental properties of solids and liquids ii liquids 1,1917,15
Chemistry,carl bosch,1931,formation of anthracite,1913,18
Chemistry,carl bosch,1931,ABSORBING AMMONIA AND APPARATUS THEREFOR,1913,18
Chemistry,"fischer, h",1930,Einfluss der configuration auf die wirkung der enzyme.,1894,36
Chemistry,"harden, a",1929,the alcoholic ferment of yeast juice,1906,23
Chemistry,"von euler, h",1929,enzymatische spaltung von dipeptiden ii,1926,3
Chemistry,"windaus, a",1928,untersuchungen uber die konstitution des colchicins,1924,4
Chemistry,"windaus, a",1928,uber ein in chloroform unlosliches glykosid aus digitalis blattern das gitoxin,1925,3
Chemistry,"wieland, h",1927,uber den mechanismus der oxydationsvorgange,1922,5
Chemistry,"svedberg, t",1926,the ultra centrifuge a new instrument for the determination of size and distribution of size of particle in amicroscopic colloids,1924,2
Chemistry,"svedberg, t",1926,determination of size and distribution of size of particle by centrifugal methods,1923,3
Chemistry,"zsigmondy, r",1925,uber sichtbarmachung und grosenbestimmung ultramikoskopischer teilchen mit besonderer anwendung auf goldrubinglaser,1902,23
Chemistry,fritz pregl,1923,method of determination of carbon and hydrogen in organic compounds,1905,18
Chemistry,"aston, f",1922,the possibility of separating isotopes.,1919,3
Chemistry,"soddy, f",1921,the density of lead from ceylon thorite,1915,6
Chemistry,"soddy, f",1921,the origin of actinium,1913,8
Chemistry,"soddy, f",1921,cxxxii the atomic weight of lead from ceylon thorite,1914,7
Chemistry,"nernst, w",1920,spezifische warme und quantentheorie,1911,9
Chemistry,"nernst, w",1920,der energieinhalt fester stoffe,1911,9
Chemistry,"haber, f",1918,uber die technische darstellung von ammoniak aus den elementen,1913,5
Chemistry,"willstatter, r",1915,zur kenntnis der hydrolyse von cellulose i,1913,2
Chemistry,"willstatter, r",1915,untersuchungen uber die anthocyane i uber den farbstoff der kornblume,1913,2
Chemistry,"richards, t",1914,revision des atomgewichtes von casium,1903,11
Chemistry,"richards, t",1914,a revision of the atomic weights of sodium and chlorine 1,1905,9
Chemistry,"richards, t",1914,revision der atomgewichte von natrium und chlor,1905,9
Chemistry,victor grignard,1912,regarding some new organometallic combinations of magnesium and their application to alcohol synthesis and hydrocarbides.,1900,12
Chemistry,"rutherford, e",1908,lxxxiv the radioactivity of thorium compounds ii the cause and nature of radioactivity,1902,6
Medicine,"ohsumi, y",2016,isolation and characterization of autophagy defective mutants of saccharomyces cerevisiae,1993,23
Medicine,"ohsumi, y",2016,autophagy in yeast demonstrated with proteinase deficient mutants and conditions for its induction,1992,24
Medicine,youyou tu,2015,A new sesquiterpene lactone-qinghaosu,1977,38
Medicine,"omura, s",2015,avermectins new family of potent anthelmintic agents producing organism and fermentation,1979,36
Medicine,"campbell, wc",2015,avermectins new family of potent anthelmintic agents efficacy of the b1a component,1979,36
Medicine,"moser, ei",2014,microstructure of a spatial map in the entorhinal cortex,2005,9
Medicine,"okeefe, j",2014,the hippocampus as a spatial map preliminary evidence from unit activity in the freely moving rat,1971,43
Medicine,"moser, mb",2014,microstructure of a spatial map in the entorhinal cortex,2005,9
Medicine,"sudhof, tc",2013,phospholipid binding by a synaptic vesicle protein homologous to the regulatory region of protein kinase c,1990,23
Medicine,"sudhof, tc",2013,synaptotagmin a calcium sensor on the synaptic vesicle surface,1992,21
Medicine,"sudhof, tc",2013,botulinum neurotoxin a selectively cleaves the synaptic protein snap 25,1993,20
Medicine,"sudhof, tc",2013,synaptotagmin i a major ca2 sensor for transmitter release at a central synapse,1994,19
Medicine,"schekman, r",2013,secretion and cell surface growth are blocked in a temperature sensitive mutant of saccharomyces cerevisiae,1979,34
Medicine,"schekman, r",2013,identification of 23 complementation groups required for post translational events in the yeast secretory pathway,1980,33
Medicine,"rothman, je",2013,a protein assembly disassembly pathway in vitro that may correspond to sequential steps of synaptic vesicle docking activation and fusion,1993,20
Medicine,"rothman, je",2013,visualizing secretion and synaptic transmission with ph sensitive green fluorescent proteins,1998,15
Medicine,"rothman, je",2013,snarepins minimal machinery for membrane fusion,1998,15
Medicine,"rothman, je",2013,snap receptors implicated in vesicle targeting and fusion,1993,20
Medicine,"yamanaka, s",2012,induction of pluripotent stem cells from mouse embryonic and adult fibroblast cultures by defined factors,2006,6
Medicine,"yamanaka, s",2012,induction of pluripotent stem cells from adult human fibroblasts by defined factors,2007,5
Medicine,"gurdon, jb",2012,adult frogs derived from the nuclei of single somatic cells,1962,50
Medicine,"gurdon, jb",2012,the developmental capacity of nuclei taken from intestinal epithelium cells of feeding tadpoles,1962,50
Medicine,"steinman, rm",2011,identification of a novel cell type in peripheral lymphoid organs of mice i morphology quantitation tissue distribution,1973,38
Medicine,"hoffmann, ja",2011,the dorsoventral regulatory gene cassette controls the potent antifungal response in drosophila adults,1996,15
Medicine,"hoffmann, ja",2011,the dorsoventral regulatory gene cassette spatzle toll cactus controls the potent antifungal response in drosophila adults,1996,15
Medicine,"beutler, b",2011,defective lps signaling in c3h hej and c57bl 10sccr mice mutations in tlr4 gene,1998,13
Medicine,"edwards, rg",2010,birth after the reimplantation of a human embryo,1978,32
Medicine,"szostak, jw",2009,cloning yeast telomeres on linear plasmid vectors,1982,27
Medicine,"greider, cw",2009,identification of a specific telomere terminal transferase activity in tetrahymena extracts,1985,24
Medicine,"blackburn, eh",2009,cloning yeast telomeres on linear plasmid vectors,1982,27
Medicine,"blackburn, eh",2009,identification of a specific telomere terminal transferase activity in tetrahymena extracts,1985,24
Medicine,"barresinoussi, f",2008,isolation of a t lymphotropic retrovirus from a patient at risk for acquired immune deficiency syndrome aids,1983,25
Medicine,"hausen, hz",2008,a new type of papillomavirus dna its presence in genital cancer biopsies and in cell lines derived from cervical cancer,1984,24
Medicine,"montagnier, l",2008,isolation of a t lymphotropic retrovirus from a patient at risk for acquired immune deficiency syndrome aids,1983,25
Medicine,"evans, mj",2007,establishment in culture of pluripotential cells from mouse embryos,1981,26
Medicine,"capecchi, mr",2007,site directed mutagenesis by gene targeting in mouse embryo derived stem cells,1987,20
Medicine,"capecchi, mr",2007,high efficiency transformation by direct microinjection of dna into cultured mammalian cells,1980,27
Medicine,"smithies, o",2007,a comprehensive set of sequence analysis programs for the vax,1984,23
Medicine,"smithies, o",2007,targetted correction of a mutant hprt gene in mouse embryonic stem cells,1987,20
Medicine,"mello, cc",2006,potent and specific genetic interference by double stranded rna in caenorhabditis elegans,1998,8
Medicine,"fire, a",2006,potent and specific genetic interference by double stranded rna in caenorhabditis elegans,1998,8
Medicine,"warren, jr",2005,unidentified curved bacilli in the stomach of patients with gastritis and peptic ulceration,1984,21
Medicine,"marshall, bj",2005,unidentified curved bacilli in the stomach of patients with gastritis and peptic ulceration,1984,21
Medicine,"buck, l",2004,a novel multigene family may encode odorant receptors a molecular basis for odor recognition,1991,13
Medicine,"axel, r",2004,a novel multigene family may encode odorant receptors a molecular basis for odor recognition,1991,13
Medicine,"mansfield, p",2003,multi planar image formation using nmr spin echoes,1977,26
Medicine,"lauterbur, pc",2003,image formation by induced local interactions examples employing nuclear magnetic resonance,1973,30
Medicine,"horvitz, hr",2002,genetic control of programmed cell death in the nematode c elegans,1986,16
Medicine,"brenner, s",2002,the genetics of caenorhabditis elegans,1974,28
Medicine,"sulston, je",2002,post embryonic cell lineages of the nematode caenorhabditis elegans,1977,25
Medicine,"nurse, p",2001,complementation used to clone a human homologue of the fission yeast cell cycle control gene cdc2,1987,14
Medicine,"nurse, p",2001,negative regulation of mitosis by wee1 a gene encoding a protein kinase homolog,1987,14
Medicine,"hunt, t",2001,cyclin a protein specified by maternal mrna in sea urchin eggs that is destroyed at each cleavage division,1983,18
Medicine,"hartwell, lh",2001,genetic control of the cell division cycle in yeast iv genes controlling bud emergence and cytokinesis,1971,30
Medicine,"kandel, er",2000,neuronal correlates of habituation and dishabituation of the gill withdrawal reflex in aplysia,1970,30
Medicine,greengar.p,2000,cyclic nucleotide dependent protein kinases iv widespread occurrence of adenosine 3 5 monophosphate dependent protein kinase in various tissues and phyla of the animal kingdom,1969,31
Medicine,"carlsson, a",2000,a fluorimetric method for the determination of dopamine 3 hydroxytyramine,1958,42
Medicine,"carlsson, a",2000,a method for the fluorimetric determination of adrenaline and noradrenaline in tissues 1,1958,42
Medicine,"carlsson, a",2000,3 4 dihydroxyphenylalanine and 5 hydroxytryptophan as reserpine antagonists,1957,43
Medicine,"blobel, g",1999,transfer of proteins across membranes i presence of proteolytically processed and unprocessed nascent immunoglobulin light chains on membrane bound ribosomes of murine myeloma,1975,24
Medicine,"murad, f",1998,stimulation of guanylate cyclase by sodium nitroprusside nitroglycerin and nitric oxide in various tissue preparations and comparison to the effects of sodium azide and hydroxylamine,1977,21
Medicine,"murad, f",1998,nitric oxide activates guanylate cyclase and increases guanosine 3 5 cyclic monophosphate levels in various tissue preparations,1977,21
Medicine,"furchgott, rf",1998,phosphodiesterase inhibitors induce endothelium dependent relaxation of rat and rabbit aorta by potentiating the effects of spontaneously released endothelium derived relaxing factor,1986,12
Medicine,"furchgott, rf",1998,the obligatory role of endothelial cells in the relaxation of arterial smooth muscle by acetylcholine,1980,18
Medicine,"furchgott, rf",1998,depression of contractile responses in rat aorta by spontaneously released endothelium derived relaxing factor,1986,12
Medicine,"ignarro, lj",1998,endothelium derived relaxing factor from pulmonary artery and vein possesses pharmacologic and chemical properties identical to those of nitric oxide radical,1987,11
Medicine,"ignarro, lj",1998,endothelium derived relaxing factor produced and released from artery and vein is nitric oxide,1987,11
Medicine,"prusiner, sb",1997,novel proteinaceous infectious particles cause scrapie,1982,15
Medicine,zinkerna.rm,1996,restriction of in vitro t cell mediated cytotoxicity in lymphocytic choriomeningitis within a syngeneic or semiallogeneic system,1974,22
Medicine,zinkerna.rm,1996,immunological surveillance against altered self components by sensitised t lymphocytes in lymphocytic choriomeningitis,1974,22
Medicine,"doherty, pc",1996,restriction of in vitro t cell mediated cytotoxicity in lymphocytic choriomeningitis within a syngeneic or semiallogeneic system,1974,22
Medicine,"doherty, pc",1996,immunological surveillance against altered self components by sensitised t lymphocytes in lymphocytic choriomeningitis,1974,22
Medicine,"nussleinvolhard, c",1995,mutations affecting segment number and polarity in drosophila,1980,15
Medicine,"wieschaus, e",1995,mutations affecting segment number and polarity in drosophila,1980,15
Medicine,"lewis, eb",1995,a gene complex controlling segmentation in drosophila,1978,17
Medicine,"rodbell, m",1994,the glucagon sensitive adenyl cyclase system in plasma membranes of rat liver iv effects of guanyl nucleotides on binding of 125i glucagon,1971,23
Medicine,"rodbell, m",1994,the glucagon sensitive adenyl cyclase system in plasma membranes of rat liver i properties,1971,23
Medicine,"rodbell, m",1994,adenyl cyclase in fat cells ii hormone receptors,1969,25
Medicine,"rodbell, m",1994,adenyl cyclase in fat cells i properties and the effects of adrenocorticotropin and fluoride,1969,25
Medicine,"rodbell, m",1994,the glucagon sensitive adenyl cyclase system in plasma membranes of rat liver iii binding of glucagon method of assay and specificity,1971,23
Medicine,"rodbell, m",1994,the glucagon sensitive adenyl cyclase system in plasma membranes of rat liver v an obligatory role of guanyl nucleotides in glucagon action,1971,23
Medicine,"gilman, ag",1994,purification of the regulatory component of adenylate cyclase,1980,14
Medicine,"sharp, pa",1993,Sizing and mapping of early adenovirus mRNAs by gel electrophoresis of S1 endonuclease-digested hybrids,1977,16
Medicine,"roberts, rj",1993,an amazing sequence arrangement at the 5 ends of adenovirus 2 messenger rna,1977,16
Medicine,"fischer, eh",1992,The phosphorylase b to a converting enzyme of rabbit skeletal muscle,1956,36
Medicine,"fischer, eh",1992,Conversion of phosphorylase b to phosphorylase a in muscle extracts.,1955,37
Medicine,"krebs, eg",1992,the reaction of sodium borohydride with muscle phosphorylase1,1958,34
Medicine,"sakmann, b",1991,mproved patch-clamp techniques for high-resolution current recording from cells and cell-free membrane patches,1981,10
Medicine,"neher, e",1991,Improved patch-clamp techniques for high-resolution current recording from cells and cell-free membrane patches,1981,10
Medicine,thomas ed,1990,SUPRALETHAL WHOLE BODY IRRADIATION AND ISOLOGOUS MARROW TRANSPLANTATION IN MAN,1959,31
Medicine,"murray, je",1990,Successful Homotransplantation of the Kidney in an Identical Twin,1956,34
Medicine,"varmus, he",1989,dna related to the transforming gene s of avian sarcoma viruses is present in normal avian dna,1976,13
Medicine,"bishop, jm",1989,dna related to the transforming gene s of avian sarcoma viruses is present in normal avian dna,1976,13
Medicine,"black, jw",1988,pharmacology of a new adrenergic beta receptor blocking compound nethalide,1962,26
Medicine,"black, jw",1988,definition and antagonism of histamine h2 receptors,1972,16
Medicine,"hitchings, gh",1988,antagonists of nucleic acid derivatives viii synergism in combinations of biochemically related antimetabolites,1954,34
Medicine,"hitchings, gh",1988,studies on condensed pyrimidine systems ix the synthesis of some 6 substituted purines,1952,36
Medicine,"elion, gb",1988,antagonists of nucleic acid derivatives viii synergism in combinations of biochemically related antimetabolites,1954,34
Medicine,"elion, gb",1988,studies on condensed pyrimidine systems ix the synthesis of some 6 substituted purines,1952,36
Medicine,"tonegawa, s",1987,evidence for somatic rearrangement of immunoglobulin genes coding for variable and constant regions,1976,11
Medicine,"cohen, s",1986,a nerve growth stimulating factor isolated from sarcom as 37 and 180,1954,32
Medicine,"cohen, s",1986,a nerve growth stimulating factor isolated from snake venom,1956,30
Medicine,"levimontalcini, r",1986,effects of mouse tumor transplantation on the nervous system,1952,34
Medicine,"brown, ms",1985,binding and degradation of low density lipoproteins by cultured human fibroblasts comparison of cells from a normal subject and from a patient with homozygous familial hypercholesterolemia,1974,11
Medicine,"brown, ms",1985,regulation of 3 hydroxy 3 methylglutaryl coenzyme a reductase activity in human fibroblasts by lipoproteins,1973,12
Medicine,"goldstein, jl",1985,binding and degradation of low density lipoproteins by cultured human fibroblasts comparison of cells from a normal subject and from a patient with homozygous familial hypercholesterolemia,1974,11
Medicine,"milstein, c",1984,continuous cultures of fused cells secreting antibody of predefined specificity,1975,9
Medicine,"kohler, g",1984,continuous cultures of fused cells secreting antibody of predefined specificity,1975,9
Medicine,"jerne, nk",1984,towards a network theory of the immune system,1974,10
Medicine,"jerne, nk",1984,the natural selection theory of antibody formation,1955,29
Medicine,"mcclintock, b",1983,the stability of broken ends of chromosomes in zea mays,1941,42
Medicine,"mcclintock, b",1983,the origin and behavior of mutable loci in maize,1950,33
Medicine,"mcclintock, b",1983,the fusion of broken ends of chromosomes following nuclear fusion,1942,41
Medicine,"mcclintock, b",1983,chromosome organization and genic expression,1951,32
Medicine,"mcclintock, b",1983,mutable loci in maize,1951,32
Medicine,samuelss.b,1982,isolation and structure of two prostaglandin endoperoxides that cause platelet aggregation,1974,8
Medicine,samuelss.b,1982,thromboxanes a new group of biologically active compounds derived from prostaglandin endoperoxides,1975,7
Medicine,samuelss.b,1982,prostaglandin endoperoxides vii novel transformations of arachidonic acid in guinea pig lung,1974,8
Medicine,samuelss.b,1982,prostaglandin endoperoxides novel transformations of arachidonic acid in human platelets,1974,8
Medicine,samuelss.b,1982,arachidonic acid metabolism in polymorphonuclear leukocytes effects of ionophore a23187,1979,3
Medicine,samuelss.b,1982,leukotriene c a slow reacting substance from murine mastocytoma cells,1979,3
Medicine,"vane, jr",1982,inhibition of prostaglandin synthesis as a mechanism of action for aspirin like drugs,1971,11
Medicine,"vane, jr",1982,an enzyme isolated from arteries transforms prostaglandin endoperoxides to an unstable substance that inhibits platelet aggregation,1976,6
Medicine,"bergstrom, s",1982,observations on the effects of infusion of prostnglnndin e in man,1959,23
Medicine,"bergstrom, s",1982,on the regulation of bile acid formation in the rat liver,1958,24
Medicine,"hubel, dh",1981,comparison of the effects of unilateral and bilateral eye closure on cortical unit responses in kittens,1965,16
Medicine,"hubel, dh",1981,receptive fields and functional architecture in two nonstriate visual areas 18 and 19 of the cat,1965,16
Medicine,"hubel, dh",1981,single cell responses in striate cortex of kittens deprived of vision in one eye,1963,18
Medicine,"hubel, dh",1981,receptive fields binocular interaction and functional architecture in the cat s visual cortex,1962,19
Medicine,"hubel, dh",1981,receptive fields and functional architecture of monkey striate cortex,1968,13
Medicine,"sperry, rw",1981,chemoaffinity in the orderly growth of nerve fiber patterns and connections,1963,18
Medicine,"wiesel, tn",1981,comparison of the effects of unilateral and bilateral eye closure on cortical unit responses in kittens,1965,16
Medicine,"wiesel, tn",1981,receptive fields and functional architecture in two nonstriate visual areas 18 and 19 of the cat,1965,16
Medicine,"wiesel, tn",1981,single cell responses in striate cortex of kittens deprived of vision in one eye,1963,18
Medicine,"wiesel, tn",1981,receptive fields binocular interaction and functional architecture in the cat s visual cortex,1962,19
Medicine,"wiesel, tn",1981,receptive fields and functional architecture of monkey striate cortex,1968,13
Medicine,"snell, gd",1980,some transamination reactions involving vitamin b6,1952,28
Medicine,"dausset, j",1980,the serology and the prognosis of 128 cases of autoimmune hemolytic anemia,1959,21
Medicine,"dausset, j",1980,acquired hemolytic anemia with polyagglutinability of red blood cells due to a new factor present in normal human serum anti tn,1959,21
Medicine,"dausset, j",1980,leukoagglutinins v leukoagglutinins in chronic idiopathic or symptomatic pancytopenia and in paroxysmal nocturnal hemoglobinuria,1954,26
Medicine,benacerr.b,1980,the role of the reticuloendothelial system in the host reaction to neoplasia,1961,19
Medicine,benacerr.b,1980,properties of antibodies cytophilic for macrophages,1966,14
Medicine,benacerr.b,1980,properties of guinea pig 7s antibodies i electrophoretic separation of two types of guinea pig 7s antibodies,1963,17
Medicine,benacerr.b,1980,studies on the specificity of the cellular infiltrate in delayed hypersensitivity reactions,1963,17
Medicine,benacerr.b,1980,properties of guinea pig 7s antibodies ii identification of antibodies involved in passive cutaneous and systemic anaphylaxis,1963,17
Medicine,"hounsfield, gn",1979,computerized transverse axial scanning tomography part 1 description of system,1973,6
Medicine,"cormack, am",1979,representation of a function by its line integrals with some radiological applications,1963,16
Medicine,"nathans, d",1978,specific cleavage of simian virus 40 dna by restriction endonuclease of hemophilus influenzae,1971,7
Medicine,"arber, w",1978,host specificity of dna produced by escherichia coli ii control over acceptance of dna from infecting phage ,1962,16
Medicine,"smith, ho",1978,a restriction enzyme from hemophilus influenzae i purification and general properties,1970,8
Medicine,"smith, ho",1978,a restriction enzyme from hemophilus influenzae ii base sequence of the recognition site,1970,8
Medicine,"schally, av",1977,isolation and properties of porcine thyrotropin releasing hormone,1969,8
Medicine,"schally, av",1977,discovery of modification of the synthetic tripeptide sequence of the thyrotropin releasing hormone having activity,1969,8
Medicine,"schally, av",1977,the identity of chemical and hormonal properties of the thyrotropin releasing hormone and pyroglutamyl histidyl proline amide,1969,8
Medicine,guillemi.r,1977,characterization of ovine hypothalamic hypophysiotropic tsh releasing factor,1970,7
Medicine,"yalow, rs",1977,immunoassay of endogenous plasma insulin in man,1960,17
Medicine,"yalow, rs",1977,assay of plasma insulin in human subjects by immunological methods,1959,18
Medicine,"yalow, rs",1977,quantitative aspects of the reaction between insulin and insulin binding antibody,1959,18
Medicine,"yalow, rs",1977,insulin i131 metabolism in human subjects demonstration of insulin binding globulin in the circulation of insulin treated subjects,1956,21
Medicine,"gajdusek, dc",1976,experimental transmission of a kuru like syndrome to chimpanzees,1966,10
Medicine,"blumberg, bs",1976,a new antigen in leukemia sera,1965,11
Medicine,baltimor.d,1975,viral rna dependent dna polymerase rna dependent dna polymerase in virions of rna tumour viruses,1970,5
Medicine,"temin, hm",1975,viral rna dependent dna polymerase rna dependent dna polymerase in virions of rous sarcoma virus,1970,5
Medicine,"dulbecco, r",1975,plaque formation and isolation of pure lines with poliomyelitis viruses,1954,21
Medicine,"duve, cd",1974,tissue fractionation studies 5 the association of acid phosphatase with a special class of cytoplasmic granules in rat liver,1955,19
Medicine,"duve, cd",1974,tissue fractionation studies 6 intracellular distribution patterns of enzymes in rat liver tissue,1955,19
Medicine,"duve, cd",1974,tissue fractionation studies 4 comparative study of the binding of acid phosphatase  glucuronidase and cathepsin by rat liver particles,1955,19
Medicine,"palade, ge",1974,a small particulate component of the cytoplasm,1955,19
Medicine,"palade, ge",1974,the fine structure of neurons,1955,19
Medicine,"claude, a",1974,the distribution of cytochrome oxidase and succinoxidase in the cytoplasm of the mammalian liver cell,1946,28
Medicine,"claude, a",1974,fractionation of mammalian liver cells by differential centrifugation ii experimental procedures and results,1946,28
Medicine,"claude, a",1974,fractionation of mammalian liver cells by differential centrifugation i problems methods and preparation of extract,1946,28
Medicine,"claude, a",1974,a study of tissue culture cells by electron microscopy methods and preliminary observations,1945,29
Medicine,karl von frisch,1973,Aus dem Leben der Bienen,1927,46
Medicine,"lorenz, k",1973,Der Kumpan in der Umwelt des Vogels,1935,38
Medicine,"lorenz, k",1973,ber die Bildung des Instinktbegriffes,1937,36
Medicine,"lorenz, k",1973,The Companion in the Bird's World,1937,36
Medicine,"edelman, gm",1972,dissociation of  globulin,1959,13
Medicine,"porter, rr",1972,the hydrolysis of rabbit  globulin and antibodies with crystalline papain,1959,13
Medicine,"sutherland, ew",1971,adenyl cyclase iii the effect of catecholamines and choline esters on the formation of adenosine 3 5 phosphate by preparations from cardiac muscle and liver,1962,9
Medicine,"sutherland, ew",1971,adenyl cyclase iv the effects of neurohormones on the formation of adenosine 3 5 phosphate by preparations from brain and other tissues,1962,9
Medicine,"sutherland, ew",1971,adenyl cyclase i distribution preparation and properties,1962,9
Medicine,"sutherland, ew",1971,adenosine 3 5 phosphate in biological materials i purification and properties of cyclic 3 5 nucleotide phosphodiesterase and use of this enzyme to characterize adenosine 3 5 phosphate in human urine,1962,9
Medicine,von euler us,1970,evidence for the presence of noradrenaline in submicroscopic structures of adrenergic axons,1956,14
Medicine,"axelrod, j",1970,enzymatic o methylation of epinephrine and other catechols,1958,12
Medicine,"axelrod, j",1970,o methylation of epinephrine and other catechols in vitro and in vivo,1957,13
Medicine,"katz, b",1970,a study of the desensitization produced by acetylcholine at the motor end plate,1957,13
Medicine,"katz, b",1970,the effect of sodium ions on the electrical activity of the giant axon of the squid,1949,21
Medicine,"katz, b",1970,spontaneous subthreshold activity at motor nerve endings,1952,18
Medicine,"katz, b",1970,quantal components of the end plate potential,1954,16
Medicine,"katz, b",1970,an analysis of the end plate potential recorded with an intra cellular electrode,1951,19
Medicine,"luria, se",1969,MUTATIONS OF BACTERIA FROM VIRUS SENSITIVITY TO VIRUS RESISTANCE,1943,26
Medicine,"hershey, ad",1969,independent functions of viral protein and nucleic acid in growth of bacteriophage,1952,17
Medicine,"delbruck, m",1969,MUTATIONS OF BACTERIA FROM VIRUS SENSITIVITY TO VIRUS RESISTANCE,1943,26
Medicine,"nirenberg, m",1968,the dependence of cell free protein synthesis in e coli upon naturally occurring or synthetic polyribonucleotides,1961,7
Medicine,"nirenberg, m",1968,the dependence of cell free protein synthesis in e coli upon naturally occuring or synthetic polyribonucleotides,1961,7
Medicine,"khorana, hg",1968,studies on polynucleotides iii enzymic degradation substrate specificity and properties of snake venom phosphodiesterase,1959,9
Medicine,"khorana, hg",1968,carbodiimides viii 1 observations on the reactions of carbodiimides with acids and some new applications in the synthesis of phosphoric acid esters,1958,10
Medicine,"khorana, hg",1968,nucleoside polyphosphates x 1 the synthesis and some reactions of nucleoside 5 phosphoromorpholidates and related compounds improved methods for the preparation of nucleoside 5 polyphosphates1,1961,7
Medicine,"khorana, hg",1968,studies on polynucleotides xxiv 1 the stepwise synthesis of specific deoxyribopolynucleotides 4 2 protected derivatives of deoxyribonucleosides and new syntheses of deoxyribonucleoside 3 phosphates3,1963,5
Medicine,"khorana, hg",1968,studies on polynucleotides xiv 1specific synthesis of the c3 c5 interribonucleotide linkage syntheses of uridylyl 3 5 uridine and uridylyl 3 5 adenosine2,1962,6
Medicine,"holley, rw",1968,Structure of a Ribonucleic Acid,1965,3
Medicine,"granit, r",1967,tonic and phasic ventral horn cells differentiated by post tetanic potentiation in cat extensors,1956,11
Medicine,"granit, r",1967,fibre interaction in injured or compressed region of nerve,1944,23
Medicine,"granit, r",1967,excitatory and inhibitory processes acting upon individual purkinje cells of the cerebellum in cats,1956,11
Medicine,"granit, r",1967,supraspinal control of the muscle spindles and its significance,1953,14
Medicine,"granit, r",1967,the components of the retinal action potential in mammals and their relation to the discharge in the optic nerve,1933,34
Medicine,"hartline, hk",1967,the peripheral origin of nervous activity in the visual system,1952,15
Medicine,"wald, g",1967,pre lumirhodopsin and the bleaching of visual pigments,1963,4
Medicine,"wald, g",1967,cis trans isomers of vitamin a and retinene in the rhodopsin system,1952,15
Medicine,"wald, g",1967,cistrans isomers of vitamin a and retinene in vision,1952,15
Medicine,"wald, g",1967,the molar extinction of rhodopsin,1953,14
Medicine,"huggins, c",1966,studies on prostatic cancer i the effect of castration of estrogen and of androgen injection on serum phosphatases in metastatic carcinoma of the prostate,1941,25
Medicine,"rous, p",1966,a transmissible avian neoplasm sarcoma of the common fowl,1910,56
Medicine,"rous, p",1966,a sarcoma of the fowl transmissible by an agent separable from the tumor cells,1911,55
Medicine,"monod, j",1965,genetic regulatory mechanisms in the synthesis of proteins,1961,4
Medicine,"lwoff, a",1965,induction of bacteriophage production in a bacterium,1950,15
Medicine,"jacob, f",1965,genetic regulatory mechanisms in the synthesis of proteins,1961,4
Medicine,"jacob, f",1965,allosteric proteins and cellular control systems,1963,2
Medicine,"jacob, f",1965,on the regulation of gene activity,1961,4
Medicine,"jacob, f",1965,general conclusions teleonomic mechanisms in cellular metabolism growth and differentiation,1961,4
Medicine,"lynen, f",1964,enzymes of fatty acid metabolism,1953,11
Medicine,"bloch, k",1964,the biological conversion of cholesterol to cholic acid,1943,21
Medicine,"eccles, jc",1963,cholinergic and inhibitory synapses in a pathway from motor axon collaterals to motoneurones,1954,9
Medicine,"eccles, jc",1963,the recording of potentials from motoneurones with an intracellular electrode,1952,11
Medicine,"hodgkin, al",1963,a quantitative description of membrane current and its application to conduction and excitation in nerve,1952,11
Medicine,"huxley, af",1963,a quantitative description of membrane current and its application to conduction and excitation in nerve,1952,11
Medicine,"wilkins, mhf",1962,molecular structure of deoxypentose nucleic acids,1953,9
Medicine,"watson, jd",1962,genetical implications of the structure of deoxyribonucleic acid,1953,9
Medicine,"watson, jd",1962,molecular structure of nucleic acids a structure for deoxyribose nucleic acid,1953,9
Medicine,"watson, jd",1962,the structure of dna,1953,9
Medicine,"crick, fhc",1962,genetical implications of the structure of deoxyribonucleic acid,1953,9
Medicine,"crick, fhc",1962,the packing of  helices simple coiled coils,1953,9
Medicine,"crick, fhc",1962,molecular structure of nucleic acids a structure for deoxyribose nucleic acid,1953,9
Medicine,"vonbekesy, g",1961,the variation of phase along the basilar membrane with sinusoidal vibrations,1947,14
Medicine,"vonbekesy, g",1961,a new audiometer,1947,14
Medicine,"medawar, pb",1960,the technique of free skin grafting in mammals,1951,9
Medicine,"burnet, fm",1960,the failure of antibody production in the chick embryo,1950,10
Medicine,"kornberg, a",1959,enzymatic synthesis of deoxyribonucleic acid i preparation of substrates and partial purification of an enzyme from escherichia coli,1958,1
Medicine,"ochoa, s",1959,116 isocitric dehydrogenase system tpn from pig heart,1955,4
Medicine,"ochoa, s",1959,124 malic enzyme,1955,4
Medicine,"lederberg, j",1958,gene recombination in escherichia coli,1946,12
Medicine,"beadle, gw",1958,genetic control of biochemical reactions in neurospora,1941,17
Medicine,"tatum, el",1958,genetic control of biochemical reactions in neurospora,1941,17
Medicine,"bovet, d",1957,protective effect of phenolic ethers in the course of histaminic intoxication.,1937,20
Medicine,"richards, dw",1956,pulmonary in sufficiency i physiological classification clinical methods of analysis standard values in normal subjects,1948,8
Medicine,"richards, dw",1956,physiological studies of the effects of intermittent positive pressure breathing on cardiac output in man,1947,9
Medicine,"richards, dw",1956,comparison of the fick and dye injection methods of measuring the cardiac output in man,1948,8
Medicine,"cournand, a",1956,pulmonary in sufficiency i physiological classification clinical methods of analysis standard values in normal subjects,1948,8
Medicine,"cournand, a",1956,physiological studies of the effects of intermittent positive pressure breathing on cardiac output in man,1947,9
Medicine,"cournand, a",1956,comparison of the fick and dye injection methods of measuring the cardiac output in man,1948,8
Medicine,"theorell, h",1955,the yellow oxidation-enzyme,1935,20
Medicine,"robbins, fc",1954,cultivation of the lansing strain of poliomyelitis virus in cultures of various human embryonic tissues,1949,5
Medicine,"weller, th",1954,cultivation of the lansing strain of poliomyelitis virus in cultures of various human embryonic tissues,1949,5
Medicine,"enders, jf",1954,cultivation of the lansing strain of poliomyelitis virus in cultures of various human embryonic tissues,1949,5
Medicine,"lipmann, f",1953,a specific micromethod for the determination of acyl phosphates,1945,8
Medicine,"krebs, ha",1953,metabolism of ketonic acids in animal tissues,1937,16
Medicine,"waksman, sa",1952,the soil as a source of microorganisms antagonistic to disease producing bacteria,1940,12
Medicine,"waksman, sa",1952,streptomycin a substance exhibiting antibiotic activity against gram positive and gram negative bacteria,1944,8
Medicine,"waksman, sa",1952,bacteriostatic and bactericidal substances produced by a soil actinomyces,1940,12
Medicine,"theiler, m",1951,spontaneous encephalomyelitis of mice a new virus disease,1937,14
Medicine,"kendall, ec",1950,the chemistry of crystalline substances isolated from the suprarenal gland,1936,14
Medicine,"kendall, ec",1950,atrophy of the adrenal cortex of the rat produced by the administration of large amounts of cortin,1937,13
Medicine,"reichstein, t",1950,eine ergiebige synthese der l ascorbinsaure c vitamin,1934,16
Medicine,"reichstein, t",1950,desoxy cortico steron 21 oxy progesteron aus 5 3 oxy atio cholensaure,1937,13
Medicine,"hench, ps",1950,the effect of a hormone of the adrenal cortex (17-hydroxy-11-dehydrocorticosterone - compound-e) and of pituitary adrenocorticotropic hormone on rheumatoid arthritis - preliminary report,1949,1
Medicine,"hess, wr",1949,hypothalamus und die zentren des autonomen nervensystems physiologie,1936,13
Medicine,"moniz, e",1949,prefrontal leucotomy in the treatment of mental disorders,1937,12
Medicine,"muller, p",1948,the constitution and toxic effect of natural and new synthetic insect killing substances,1944,4
Medicine,"cori, gt",1947,glycogen formation in the liver from d and l lactic acid,1929,18
Medicine,"houssay, ba",1947,the sensitivity to hypertensin adrenalin and renin of unanesthetized normal adrenalectomized hypophysectomized and nephrectomized dogs,1942,5
Medicine,"houssay, ba",1947,thyroid and metathyroid diabetes,1944,3
Medicine,"cori, cf",1947,glycogen formation in the liver from d and l lactic acid,1929,18
Medicine,"muller, hj",1946,the measurement of gene mutation rate in drosophila its high variability and its dependence upon temperature,1928,18
Medicine,"muller, hj",1946,the production of mutations by x rays,1928,18
Medicine,"chain, e",1945,an enzyme from bacteria able to destroy penicillin,1940,5
Medicine,"chain, e",1945,further observations on penicillin,1941,4
Medicine,"chain, e",1945,penicillin as a chemotherapeutic agent,1940,5
Medicine,"fleming, a",1945,on the antibacterial action of cultures of a penicillium with special reference to their use in the isolation of b influenzae,1929,16
Medicine,"florey, hw",1945,penicillin as a chemotherapeutic agent,1940,5
Medicine,"erlanger, j",1944,the role of fiber size in the establishment of a nerve block by pressure or cocaine,1929,15
Medicine,"erlanger, j",1944,a study of the action currents of nerve with the cathode ray oscillograph,1922,22
Medicine,"erlanger, j",1944,the nature of conduction of an impulse in the relatively refractory period,1925,19
Medicine,"erlanger, j",1944,the compound nature of the action current of nerve as disclosed by the cathode ray oscillograph,1924,20
Medicine,"erlanger, j",1944,the role played by the sizes of the constituent fibers of a nerve trunk in determining the form of its action potential wave,1927,17
Medicine,"gasser, hs",1944,the role of fiber size in the establishment of a nerve block by pressure or cocaine,1929,15
Medicine,"gasser, hs",1944,a study of the action currents of nerve with the cathode ray oscillograph,1922,22
Medicine,"gasser, hs",1944,the nature of conduction of an impulse in the relatively refractory period,1925,19
Medicine,"gasser, hs",1944,the compound nature of the action current of nerve as disclosed by the cathode ray oscillograph,1924,20
Medicine,"gasser, hs",1944,the role played by the sizes of the constituent fibers of a nerve trunk in determining the form of its action potential wave,1927,17
Medicine,"doisy, ea",1943,the isolation of vitamin k2,1939,4
Medicine,"doisy, ea",1943,the isolation of vitamins k1 and,1939,4
Medicine,"dam, h",1943,the antihaemorrhagic vitamin of the chick,1935,8
Medicine,"dam, h",1943,the antihaemorrhagic vitamin of the chick occurrence and chemical nature,1935,8
Medicine,"domagk, g",1939,ein beitrag zur chemotherapie der bakteriellen infektionen,1935,4
Medicine,"domagk, g",1939,eine neue klasse von desinfektionsmitteln,1935,4
Medicine,"heymans, c",1938,"the mechanism of bradycardia caused by nicotine, lobeline, cyanine, sodium sulphur, nitrite and morphine. the asphyctic bradycardia",1931,7
Medicine,"gyorgyi, as",1937,hexuronic acid as the antiscorbutic factor,1932,5
Medicine,"dale, hh",1936,the action of certain esters and ethers of choline and their relation to muscarine,1914,22
Medicine,"loewi, o",1936,uber humorale ubertragbarkeit der herznervenwirkung,1924,12
Medicine,"spemann, h",1935,uber induktion von embryonalanlagen durch implantation artfremder organisatoren,1924,11
Medicine,"minot, gr",1934,treatment of pernicious anemia by a special diet,1926,8
Medicine,"minot, gr",1934,a diet rich in liver in the treatment of pernicious anemia study of one hundred and five cases,1927,7
Medicine,"whipple, gh",1934,blood volume studies iii behavior of large series of dyes introduced into the circulating blood,1920,14
Medicine,"murphy, wp",1934,treatment of pernicious anemia by a special diet,1926,8
Medicine,"murphy, wp",1934,a diet rich in liver in the treatment of pernicious anemia study of one hundred and five cases,1927,7
Medicine,"morgan, th",1933,sex limited inheritance in drosophila,1916,17
Medicine,"adrian, ed",1932,the discharge of impulses in motor nerve fibres part i impulses in single fibres of the phrenic nerve,1928,4
Medicine,"adrian, ed",1932,the discharge of impulses in motor nerve fibres part ii the frequency of discharge in reflex and voluntary contractions,1929,3
Medicine,"warburg, o",1931,uber die wirkung des kohlenoxyds auf den stoffwechsel der hefe,1928,3
Medicine,"warburg, o",1931,uber die geschwindigkeit der photochemischen kohlensaurezersetzung in lebenden zellen ii,1928,3
Medicine,"hopkins, fg",1929,feeding experiments illustrating the importance of accessory factors in normal dietaries,1912,17
Medicine,"nicolle, c",1928,experimental reproduction of exanthematic typhus in the monkey,1909,19
Medicine,"nicolle, c",1928,experiemntal transmission of the exanthematic typhus by the body louse.,1909,19
Medicine,"einthoven, w",1924,ein neues galvanometer,1903,21
Medicine,"macleod, jjr",1923,The internal secretion of the pancreas,1921,2
Medicine,"banting, fg",1923,pancreatic extracts in the treatment of diabetes mellitus,1922,1
Medicine,"banting, fg",1923,the internal secretion of the pancreas,1922,1
Medicine,"meyerhof, o",1922,uber die atmung der froschmuskulatur,1919,3
Medicine,"hill, av",1922,a new mathematical treatment of changes of ionic concentration in muscle and nerve under the action of electric currents with a theory as to their mode of excitation,1910,12
Medicine,"hill, av",1922,the combinations of haemoglobin with oxygen and with carbon monoxide i,1913,9
Medicine,"krogh, a",1920,the rate of diffusion of gases through animal tissues with some remarks on the coefficient of invasion,1919,1
Medicine,"krogh, a",1920,the regulation of respiration and circulation during the initial stages of muscular work,1913,7
Medicine,"krogh, a",1920,the number and distribution of capillaries in muscles with calculations of the oxygen pressure head necessary for supplying the tissue,1919,1
Medicine,"krogh, a",1920,the supply of oxygen to the tissues and the regulation of the capillary circulation,1919,1
Medicine,charles robert richet,1913,the anaphylactic effect of certain venoms,1902,11
Medicine,charles robert richet,1913,the anaphylactic effects of the actinotoxin on the arterial pressure,1902,11
Medicine,charles robert richet,1913,the physiological effects of the poison of fisher strands and tentacles of coelenterata (hypnotoxin),1902,11
Medicine,"carrel, a",1912,viii on the experimental surgery of the thoracic aorta and heart,1910,2
Medicine,"carrel, a",1912,results of the transplantation of blood vessels organs and limbs,1908,4
Medicine,"carrel, a",1912,results of the biterminal transplantation of veins,1906,6
Medicine,"carrel, a",1912,the surgery of blood vessels etc,1907,5